abberant : aberrant
abberation : aberration
abbrieviated : abbreviated
abbriviated : abbreviated
abbriviation : abbreviation
abcess : abscess
aberation : aberration
aberrent : aberrant
abilites : abilities
abillity : ability
abilty : ability
abondon : abandon
abreviate : abbreviate
abreviation : abbreviation
abritrary : arbitrary
abscence : absence
absorbant : absorbent
absorbsion : absorption
absoulte : absolute
abudance : abundance
abundacies : abundances
abundence : abundance
acadamy : academy
acadmic : academic
accadamy : academy
accademy : academy
accellerate : accelerate
accelleration : acceleration
acceptible : acceptable
accessable : accessible
accesed : accessed
accesory : accessory
accidentaly : accidentally
acclimitization : acclimatization
accomadate : accommodate
accomadation : accommodation
accomodate : accommodate
accomodation : accommodation
accompaning : accompanying
accompanyed : accompanied
accordeon : accordion
accordian : accordion
accoring : according
accoustic : acoustic
accreditate : accredit
accros : across
acertain : ascertain
acess : access
acheive : achieve
acheived : achieved
acheivement : achievement
acording : according
acordingly : accordingly
acuracy : accuracy
acustom : accustom
addittion : addition
addmission : admission
addmitted : admitted
addopt : adopt
adhear : adhere
aditional : additional
admendment : amendment
adminstrator : administrator
admissability : admissibility
admissable : admissible
adn : and
adolecent : adolescent
adquire : acquire
affter : after
bacame : became
backpeddle : backpedal
backruptcy : bankruptcy
backround : background
badmiton : badminton
badmitton : badminton
bakc : back
balence : balance
baleout : bailout
ballest : ballast
bandwith : bandwidth
bankrupcy : bankruptcy
bannana : banana
baord : board
basicaly : basically
basicly : basically
bcak : back
beacause : because
beacuse : because
bearly : barely
beatiful : beautiful
beeen : been
beeing : being
beetween : between
beetwen : between
befoer : before
befor : before
begginer : beginner
beggining : beginning
Bejing : Beijing
beleave : believe
beleif : belief
beleive : believe
Belguim : Belgium
cacaphony : cacophony
caffiene : caffeine
calandar : calendar
Califronia : California
caligraphy : calligraphy
caluclate : calculate
Cambrige : Cambridge
camoflage : camouflage
candadate : candidate
canidate : candidate
cannister : canister
caost : coast
captial : capital
captian : captain
carachter : character
careing : caring
carrear : career
Carribbean : Caribbean
cassete : cassette
casue : cause
catagory : category
catergory : category
cathlic : catholic
Celcius : Celsius
celeberate : celebrate
cencus : census
centeral : central
caluclate : calculate
centrifical : centrifugal
centruy : century
cerimony : ceremony
certian : certain
challange : challenge
chanel : channel
chemcial : chemical
chemestry : chemistry
chidren : children
claer : clear
danceing : dancing
desease : disease
desend : descend
desgin : design
desginate : designate
desgined : designed
deside : decide
desribe : describe
dialate : dilate
dialation : dilation
diaster : disaster
diciple : disciple
dicision : decision
dicover : discover
dicovery : discovery
dicuss : discuss
diesal : diesel
dieties : deities
diety : deity
discribe : describe
distirb : disturb
driectly : directly
ealier : earlier
eary : early
eccessive : excessive
eclispe : eclipse
ecomonic : economic
ecomony : economy
effeciency : efficiency
elaborite : elaborate
electrial : electrical
eleminated : eliminated
eletronic : electronic
elphant : elephant
embeded : embedded
emiter : emitter
emmediately : immediately
emmense : immense
emnity : enmity
empahsis : emphasis
emperical : empirical
exaust : exhaust
excape : escape
excecute : execute
excecution : execution
excedded : exceeded
excelent : excellent
excell : excel
excercise : exercise
execpt : except
exemple : example
exept : except
exerbate : exacerbate
Fabruary : February
faciliate : facilitate
facimile : facsimile
fairwell : farewell
faithfull : faithful
faliure : failure
famaly : family
familar : familiar
familes : families
familiy : family
famouse : famous
Farenheit : Fahrenheit
fasion : fashion
feasable : feasible
feauture : feature
feirce : fierce
ffrom : from
fianl : final
fianlly : finally
filiament : filament
filmaker : filmmaker
filmaking : filmmaking
finaly : finally
finnished : finished
firend : friend
firey : fiery
firt : first
fith : fifth
fixure : fixture
Flemmish : Flemish
focuse : focus
foilage : foliage
folicle : follicle
folow : follow
folowed : followed
folower : follower
folowing : following
fomer : former
forcast : forecast
forcasting : forecasting
forebid : forbid
forebidden : forbidden
guage : gauge
guarentee : guarantee
grwo : grow
granfather : grandfather
granmother : grandmother
grammer : grammar
govorment : government
giude : guide
habaeus : habeas
habbit : habit
handfull : handful
hankerchief : handkerchief
hapen : happen
hapened : happened
hapening : happening
happend : happened
happended : happened
haras : harass
hardwear : hardware
headquartes : headquarters
headquater : headquarter
Heidelburg : Heidelberg
heigher : higher
heigth : height
heirarchy : hierarchy
helpfull : helpful
hertiage : heritage
hidding : hiding
hieght : height
higer : higher
hinderence : hindrance
hismelf : himself
histroy : history
hiting : hitting
hollistic : holistic
homocide : homicide
hopeing : hoping
horrifing : horrifying
hosptial : hospital
housewifes : housewives
houshold : household
houskeeper : housekeeper
howver : however
hundered : hundred
hurricaine : hurricane
husban : husband
hvae : have
hydralic : hydraulic
hydropile : hydrophile
hydropilic : hydrophilic
hydropobe : hydrophobe
hydropobic : hydrophobic
hygeine : hygiene
hygene : hygiene
hypocracy : hypocrisy
hypocrasy : hypocrisy
hypocricy : hypocrisy
hypocrit : hypocrite
hyptonize : hypnotize
iceburg : iceberg
iceing : icing
iconclastic : iconoclastic
idae :  idea
idaes : ideas
idealogies : ideologies
idealogy : ideology
idealy : ideally
idenify : identify
idenity : identity
identicaly : identically
identicial : identical
identifed : identified
identifing : identifying
iin : in
ilegally : illegally
illegaly : illegally
illict : illicit
ilumination : illumination
imagenary : imaginary
imagin : imagine
imediate : immediate
imense : immense
immediatly : immediately
immensley : immensely
immensly : immensely
immidately : immediately
immidiately : immediately
immitate : imitate
immuntable : immutable
imoral : immoral
impare : impair
impass : impasse
impedence : impedance
impliment : implement
imporatnt : important
importan : important
impove : improve
improvment : improvement
inaccessable : inaccessible
inappropiate : inappropriate
inapropriate : inappropriate
inate : innate
inaugrate : inaugurate
inbalance : imbalance
includeing : including
increadible : incredible
incredable : incredible
increse : increase
inctroduce : introduce
incuding : including
indefinately : indefinitely
indefinitly : indefinitely
indempotent : idempotent
indepedence : independence
indepedent : independent
individial : individual
indulgue : indulge
indurance : endurance
indure : endure
indutrial : industrial
inevatible : inevitable
inevitible : inevitable
infectuous : infectious
infilitrate : infiltrate
infinate : infinite
infinit : infinite
infomation : information
inforamtion : information
infromation : information
ingreediants : ingredients
inheret : inherit
inherrent : inherent
inicial : initial
iniciate : initiate
inital : initial
initate : initiate
injuiry : injury
inlcude : include
inlude : include
inmigrant : immigrant
interfearance : interference
interfearing : interfering
interferance : interference
intergral  : integral
intergrate : integrate
intergrated : integrated
intergration : integration
intermidiary : intermediary
intermidiate : intermediate
internaly : internally
internation : international
internationaly : internationally
interogation : interrogation
interoir : interior
interor : interior
interpet : interpret
interpetation : interpretation
interpretate : interpret
interprete : interpret
interpretion : interpretation
interpretor : interpreter
interpretted : interpreted
interrior : interior
interregum : interregnum
interrugum : interregnum
interruptable : interruptible
interseted : interested
interst : interest
intertaining : entertaining
interuption : interruption
intesity : intensity
intial : initial
intially : initially
intigrate : integrate
intoduce : introduce
intorduce : introduce
inventer : inventor
inversly : inversely
invole : involve
irelevent : irrelevant
iritable : irritable
iritate : irritate
ironical : ironic
ironicaly : ironically
ironicly : ironically
irrelavent : irrelevant
irrelevent : irrelevant
Jamacia : Jamaica
Janaury : January
Janusry : January
Janurary : January
Japaneese : Japanese
Japanes : Japanese
jeapardy : jeopardy
Jersualem : Jerusalem
jewler : jeweler
jorunal : journal
journy : journey
jstu : just
jsut : just
juction : junction
judical : judicial
judisuary : judiciary
juniour : junior
junoir : junior
juvinile : juvenile
keybord : keyboard
killogram : kilogram
killometer : kilometer
kindergarden : kindergarten
kingdon : kingdom
knowed : knew
knowed : known
knowldge : knowledge
knowlege : knowledge
knwo : know
knwos : knows
konw : know
konws : knows
lable : label
labratory : laboratory
ladden : laden
laguage : language
lamda : lambda
landscapping : landscaping
langauge : language
languise : languish
languistic : linguistic
lanscape : landscape
lanugage : language
largets : largest
largley : largely
largly : largely
latancy : latency
latant : latent
lateley : lately
lateraly : laterally
latern : lantern
latley : lately
lattitude : latitude
lauch : launch
launchs : launches
leasure : leisure
leauge : league
ledgend : legend
ledgendary : legendary
ledgislate : legislate
ledgislation : legislation
ledgislative : legislative
legimate : legitimate
legitamate : legitimate
legnth : length
lenght : length
lense : lens
lenth : length
leran : learn
leutenant : lieutenant
lexion : lexicon
libarary : library
libary : library
liek : like
liekd : liked
liesure : leisure
lieutentant : lieutenant
likelyhood : likelihood
likley : likely
lillies : lilies
lingustic : linguistic
liscence : licence
liscense : license
litature : literature
literaly : literally
literture : literature
littel : little
localy : locally
locamotive : locomotive
loev : love
logicaly : logically
lonelyness : loneliness
lonley : lonely
lovley : lovely
luckly : luckily
luxary : luxury
lveo : love
lvoe : love
Lybia : Libya
mabye : maybe
magent : magnet
magentic : magnetic
magestic : majestic
magicaly : magically
magnant : magnate
magnificient : magnificent
Maimi : Miami
mainfest : manifest
mainley : mainly
maintainance : maintenance
maintaing : maintaining
maintance : maintenance
maintanence : maintenance
maintence : maintenance
mamal : mammal
mamalian : mammalian
managament : management
manageral : managerial
managment : management
manditory : mandatory
mangement : management
mangerial : managerial
Manhatten : Manhattan
margain : margin
margine : margin
maried : married
marjority : majority
marketting : marketing
marrage : marriage
marraige : marriage
Massachussets : Massachusetts
Massachussetts : Massachusetts
masterbation : masturbation
mathamatics : mathematics
matheticians : mathematicians
mathmatician : mathematician
mathmatics : mathematics
maximalize : maximize
maximium : maximum
meaningfull : meaningful
measurment : measurement
mecanical : mechanical
mechandise : merchandise
mechanisim : mechanism
medacine : medicine
Mediteranean : Mediterranean
memeber : member
memmory : memory
mentaly : mentally
messanger : messenger
metalic : metallic
Michagan : Michigan
Michgian : Michigan
milennium : millennium
milion : million
millenium : millennium
millepede : millipede
militairy : military
millitary : military
miltary : military
mimickry : mimicry
miminal : minimal
miminum : minimum
minature : miniature
minimium : minimum
miniscule : minuscule
ministery : ministry
ministy : ministry
miniture : miniature
minning : mining
mintues : minutes
miriad : myriad
miricle : miracle
miscelaneous : miscellaneous
miscellanious : miscellaneous
miscellanous : miscellaneous
misile : missile
Misouri : Missouri
Missisipi : Mississippi
Missisippi : Mississippi
Mississipi : Mississippi
missle : missile
misstaken : mistaken
missunderstand : misunderstand
missuse : misuse
misterious : mysterious
mistery : mystery
misteryous : mysterious
mixted : mixed
mkae : make
mkaing : making
mkea : make
moderatley : moderately
moderatly : moderately
modfied : modified
modifaction : modification
modifed : modified
modle : model
moent : moment
moeny : money
mollest : molest
Monacco : Monaco
monastry : monastery
monestaries : monasteries
moniter : monitor
monoatomic : monatomic
monolite : monolithic
moraly : morally
morgage : mortgage
Morisette : Morissette
Morrocco : Morocco
motiviated : motivated
moveable : movable
movei : movie
moveing : moving
mroe : more
mucuous : mucous
muderer : murderer
mudering : murdering
mueseum : museum
mulitplayer : multiplayer
mulitple : multiple
mulitply : multiply
multiplyed : multiplied
muncipality : municipality
municipalites : municipalities
municipalties : municipalities
municipalty : municipality
municipaly : municipality
muscial : musical
musicaly : musically
musican : musician
musicial : musical
musseum : museum
musuem : museum
mutiple : multiple
mutiplication : multiplication
mutiply : multiply
mutualy : mutually
myraid : myriad
mysef : myself
mysogynist : misogynist
mysogynistic : misogynistic
mysogyny : misogyny
mysterous : mysterious











